"filename", "language", "C++", "comment", "blank", "total"
"v:\Code\exp_compile\2_yacc\parse\include\gram.h", "C++", 63, 8, 8, 79
"v:\Code\exp_compile\2_yacc\parse\include\lexer.h", "C++", 49, 11, 7, 67
"v:\Code\exp_compile\2_yacc\parse\include\parser\ll1parser.h", "C++", 19, 1, 5, 25
"v:\Code\exp_compile\2_yacc\parse\include\parser\lrparser.h", "C++", 36, 8, 12, 56
"v:\Code\exp_compile\2_yacc\parse\include\parser\parser.h", "C++", 12, 0, 2, 14
"v:\Code\exp_compile\2_yacc\parse\include\parser\recparser.h", "C++", 24, 0, 5, 29
"v:\Code\exp_compile\2_yacc\parse\include\utils.h", "C++", 17, 0, 3, 20
"v:\Code\exp_compile\2_yacc\parse\src\gram.cpp", "C++", 306, 24, 21, 351
"v:\Code\exp_compile\2_yacc\parse\src\lexer.cpp", "C++", 247, 26, 24, 297
"v:\Code\exp_compile\2_yacc\parse\src\parser\LL1parser.cpp", "C++", 139, 5, 7, 151
"v:\Code\exp_compile\2_yacc\parse\src\parser\LRparser.cpp", "C++", 296, 16, 14, 326
"v:\Code\exp_compile\2_yacc\parse\src\parser\recparser.cpp", "C++", 38, 0, 4, 42
"v:\Code\exp_compile\2_yacc\parse\test.cpp", "C++", 23, 18, 2, 43
"v:\Code\exp_compile\2_yacc\parse\test\LL1synthesis.cpp", "C++", 17, 0, 2, 19
"v:\Code\exp_compile\2_yacc\parse\test\LL1test.cpp", "C++", 13, 0, 5, 18
"v:\Code\exp_compile\2_yacc\parse\test\LRsynthesis.cpp", "C++", 16, 0, 2, 18
"v:\Code\exp_compile\2_yacc\parse\test\LRtest.cpp", "C++", 15, 0, 5, 20
"v:\Code\exp_compile\2_yacc\parse\test\Rectest.cpp", "C++", 11, 0, 4, 15
"v:\Code\exp_compile\2_yacc\parse\test\lex.cpp", "C++", 14, 0, 2, 16
"Total", "-", 1355, 117, 134, 1606